####################
#  # s   #   #  #  #
## # ## # # # # # ##
#     #   #   # E  #
# # # ########  ## #
# # #     #  ##### #
# # # # # # ##     #
# #   # #    # #####
### ### ######     #
#            ##### #
# ### ##### ##     #
#    #     # #  # ##
### ##### # ### #  #
#   #   # # # # # ##
# # # # #   #   #  #
# # # # # # # # ## #
# # # # # # # # #  #
# #   #   #   # # ##
####################